ETHBTC = 'ETHBTC',
LTCBTC = 'LTCBTC',
BNBBTC = 'BNBBTC',
NEOBTC = 'NEOBTC',
QTUMETH = 'QTUMETH',
EOSETH = 'EOSETH',
SNTETH = 'SNTETH',
BNTETH = 'BNTETH',
BCCBTC = 'BCCBTC',
GASBTC = 'GASBTC',
BNBETH = 'BNBETH',
BTCUSDT = 'BTCUSDT',
ETHUSDT = 'ETHUSDT',
HSRBTC = 'HSRBTC',
OAXETH = 'OAXETH',
DNTETH = 'DNTETH',
MCOETH = 'MCOETH',
ICNETH = 'ICNETH',
MCOBTC = 'MCOBTC',
WTCBTC = 'WTCBTC',
WTCETH = 'WTCETH',
LRCBTC = 'LRCBTC',
LRCETH = 'LRCETH',
QTUMBTC = 'QTUMBTC',
YOYOBTC = 'YOYOBTC',
OMGBTC = 'OMGBTC',
OMGETH = 'OMGETH',
ZRXBTC = 'ZRXBTC',
ZRXETH = 'ZRXETH',
STRATBTC = 'STRATBTC',
STRATETH = 'STRATETH',
SNGLSBTC = 'SNGLSBTC',
SNGLSETH = 'SNGLSETH',
BQXBTC = 'BQXBTC',
BQXETH = 'BQXETH',
KNCBTC = 'KNCBTC',
KNCETH = 'KNCETH',
FUNBTC = 'FUNBTC',
FUNETH = 'FUNETH',
SNMBTC = 'SNMBTC',
SNMETH = 'SNMETH',
NEOETH = 'NEOETH',
IOTABTC = 'IOTABTC',
IOTAETH = 'IOTAETH',
LINKBTC = 'LINKBTC',
LINKETH = 'LINKETH',
XVGBTC = 'XVGBTC',
XVGETH = 'XVGETH',
SALTBTC = 'SALTBTC',
SALTETH = 'SALTETH',
MDABTC = 'MDABTC',
MDAETH = 'MDAETH',
MTLBTC = 'MTLBTC',
MTLETH = 'MTLETH',
SUBBTC = 'SUBBTC',
SUBETH = 'SUBETH',
EOSBTC = 'EOSBTC',
SNTBTC = 'SNTBTC',
ETCETH = 'ETCETH',
ETCBTC = 'ETCBTC',
MTHBTC = 'MTHBTC',
MTHETH = 'MTHETH',
ENGBTC = 'ENGBTC',
ENGETH = 'ENGETH',
DNTBTC = 'DNTBTC',
ZECBTC = 'ZECBTC',
ZECETH = 'ZECETH',
BNTBTC = 'BNTBTC',
ASTBTC = 'ASTBTC',
ASTETH = 'ASTETH',
DASHBTC = 'DASHBTC',
DASHETH = 'DASHETH',
OAXBTC = 'OAXBTC',
ICNBTC = 'ICNBTC',
BTGBTC = 'BTGBTC',
BTGETH = 'BTGETH',
EVXBTC = 'EVXBTC',
EVXETH = 'EVXETH',
REQBTC = 'REQBTC',
REQETH = 'REQETH',
VIBBTC = 'VIBBTC',
VIBETH = 'VIBETH',
HSRETH = 'HSRETH',
TRXBTC = 'TRXBTC',
TRXETH = 'TRXETH',
POWRBTC = 'POWRBTC',
POWRETH = 'POWRETH',
ARKBTC = 'ARKBTC',
ARKETH = 'ARKETH',
YOYOETH = 'YOYOETH',
XRPBTC = 'XRPBTC',
XRPETH = 'XRPETH',
MODBTC = 'MODBTC',
MODETH = 'MODETH',
ENJBTC = 'ENJBTC',
ENJETH = 'ENJETH',
STORJBTC = 'STORJBTC',
STORJETH = 'STORJETH',
BNBUSDT = 'BNBUSDT',
VENBNB = 'VENBNB',
YOYOBNB = 'YOYOBNB',
POWRBNB = 'POWRBNB',
VENBTC = 'VENBTC',
VENETH = 'VENETH',
KMDBTC = 'KMDBTC',
KMDETH = 'KMDETH',
NULSBNB = 'NULSBNB',
RCNBTC = 'RCNBTC',
RCNETH = 'RCNETH',
RCNBNB = 'RCNBNB',
NULSBTC = 'NULSBTC',
NULSETH = 'NULSETH',
RDNBTC = 'RDNBTC',
RDNETH = 'RDNETH',
RDNBNB = 'RDNBNB',
XMRBTC = 'XMRBTC',
XMRETH = 'XMRETH',
DLTBNB = 'DLTBNB',
WTCBNB = 'WTCBNB',
DLTBTC = 'DLTBTC',
DLTETH = 'DLTETH',
AMBBTC = 'AMBBTC',
AMBETH = 'AMBETH',
AMBBNB = 'AMBBNB',
BCCETH = 'BCCETH',
BCCUSDT = 'BCCUSDT',
BCCBNB = 'BCCBNB',
BATBTC = 'BATBTC',
BATETH = 'BATETH',
BATBNB = 'BATBNB',
BCPTBTC = 'BCPTBTC',
BCPTETH = 'BCPTETH',
BCPTBNB = 'BCPTBNB',
ARNBTC = 'ARNBTC',
ARNETH = 'ARNETH',
GVTBTC = 'GVTBTC',
GVTETH = 'GVTETH',
CDTBTC = 'CDTBTC',
CDTETH = 'CDTETH',
GXSBTC = 'GXSBTC',
GXSETH = 'GXSETH',
NEOUSDT = 'NEOUSDT',
NEOBNB = 'NEOBNB',
POEBTC = 'POEBTC',
POEETH = 'POEETH',
QSPBTC = 'QSPBTC',
QSPETH = 'QSPETH',
QSPBNB = 'QSPBNB',
BTSBTC = 'BTSBTC',
BTSETH = 'BTSETH',
BTSBNB = 'BTSBNB',
XZCBTC = 'XZCBTC',
XZCETH = 'XZCETH',
XZCBNB = 'XZCBNB',
LSKBTC = 'LSKBTC',
LSKETH = 'LSKETH',
LSKBNB = 'LSKBNB',
TNTBTC = 'TNTBTC',
TNTETH = 'TNTETH',
FUELBTC = 'FUELBTC',
FUELETH = 'FUELETH',
MANABTC = 'MANABTC',
MANAETH = 'MANAETH',
BCDBTC = 'BCDBTC',
BCDETH = 'BCDETH',
DGDBTC = 'DGDBTC',
DGDETH = 'DGDETH',
IOTABNB = 'IOTABNB',
ADXBTC = 'ADXBTC',
ADXETH = 'ADXETH',
ADXBNB = 'ADXBNB',
ADABTC = 'ADABTC',
ADAETH = 'ADAETH',
PPTBTC = 'PPTBTC',
PPTETH = 'PPTETH',
CMTBTC = 'CMTBTC',
CMTETH = 'CMTETH',
CMTBNB = 'CMTBNB',
XLMBTC = 'XLMBTC',
XLMETH = 'XLMETH',
XLMBNB = 'XLMBNB',
CNDBTC = 'CNDBTC',
CNDETH = 'CNDETH',
CNDBNB = 'CNDBNB',
LENDBTC = 'LENDBTC',
LENDETH = 'LENDETH',
WABIBTC = 'WABIBTC',
WABIETH = 'WABIETH',
WABIBNB = 'WABIBNB',
LTCETH = 'LTCETH',
LTCUSDT = 'LTCUSDT',
LTCBNB = 'LTCBNB',
TNBBTC = 'TNBBTC',
TNBETH = 'TNBETH',
WAVESBTC = 'WAVESBTC',
WAVESETH = 'WAVESETH',
WAVESBNB = 'WAVESBNB',
GTOBTC = 'GTOBTC',
GTOETH = 'GTOETH',
GTOBNB = 'GTOBNB',
ICXBTC = 'ICXBTC',
ICXETH = 'ICXETH',
ICXBNB = 'ICXBNB',
OSTBTC = 'OSTBTC',
OSTETH = 'OSTETH',
OSTBNB = 'OSTBNB',
ELFBTC = 'ELFBTC',
ELFETH = 'ELFETH',
AIONBTC = 'AIONBTC',
AIONETH = 'AIONETH',
AIONBNB = 'AIONBNB',
NEBLBTC = 'NEBLBTC',
NEBLETH = 'NEBLETH',
NEBLBNB = 'NEBLBNB',
BRDBTC = 'BRDBTC',
BRDETH = 'BRDETH',
BRDBNB = 'BRDBNB',
MCOBNB = 'MCOBNB',
EDOBTC = 'EDOBTC',
EDOETH = 'EDOETH',
WINGSBTC = 'WINGSBTC',
WINGSETH = 'WINGSETH',
NAVBTC = 'NAVBTC',
NAVETH = 'NAVETH',
NAVBNB = 'NAVBNB',
LUNBTC = 'LUNBTC',
LUNETH = 'LUNETH',
TRIGBTC = 'TRIGBTC',
TRIGETH = 'TRIGETH',
TRIGBNB = 'TRIGBNB',
APPCBTC = 'APPCBTC',
APPCETH = 'APPCETH',
APPCBNB = 'APPCBNB',
VIBEBTC = 'VIBEBTC',
VIBEETH = 'VIBEETH',
RLCBTC = 'RLCBTC',
RLCETH = 'RLCETH',
RLCBNB = 'RLCBNB',
INSBTC = 'INSBTC',
INSETH = 'INSETH',
PIVXBTC = 'PIVXBTC',
PIVXETH = 'PIVXETH',
PIVXBNB = 'PIVXBNB',
IOSTBTC = 'IOSTBTC',
IOSTETH = 'IOSTETH',
CHATBTC = 'CHATBTC',
CHATETH = 'CHATETH',
STEEMBTC = 'STEEMBTC',
STEEMETH = 'STEEMETH',
STEEMBNB = 'STEEMBNB',
NANOBTC = 'NANOBTC',
NANOETH = 'NANOETH',
NANOBNB = 'NANOBNB',
VIABTC = 'VIABTC',
VIAETH = 'VIAETH',
VIABNB = 'VIABNB',
BLZBTC = 'BLZBTC',
BLZETH = 'BLZETH',
BLZBNB = 'BLZBNB',
AEBTC = 'AEBTC',
AEETH = 'AEETH',
AEBNB = 'AEBNB',
RPXBTC = 'RPXBTC',
RPXETH = 'RPXETH',
RPXBNB = 'RPXBNB',
NCASHBTC = 'NCASHBTC',
NCASHETH = 'NCASHETH',
NCASHBNB = 'NCASHBNB',
POABTC = 'POABTC',
POAETH = 'POAETH',
POABNB = 'POABNB',
ZILBTC = 'ZILBTC',
ZILETH = 'ZILETH',
ZILBNB = 'ZILBNB',
ONTBTC = 'ONTBTC',
ONTETH = 'ONTETH',
ONTBNB = 'ONTBNB',
STORMBTC = 'STORMBTC',
STORMETH = 'STORMETH',
STORMBNB = 'STORMBNB',
QTUMBNB = 'QTUMBNB',
QTUMUSDT = 'QTUMUSDT',
XEMBTC = 'XEMBTC',
XEMETH = 'XEMETH',
XEMBNB = 'XEMBNB',
WANBTC = 'WANBTC',
WANETH = 'WANETH',
WANBNB = 'WANBNB',
WPRBTC = 'WPRBTC',
WPRETH = 'WPRETH',
QLCBTC = 'QLCBTC',
QLCETH = 'QLCETH',
SYSBTC = 'SYSBTC',
SYSETH = 'SYSETH',
SYSBNB = 'SYSBNB',
QLCBNB = 'QLCBNB',
GRSBTC = 'GRSBTC',
GRSETH = 'GRSETH',
ADAUSDT = 'ADAUSDT',
ADABNB = 'ADABNB',
CLOAKBTC = 'CLOAKBTC',
CLOAKETH = 'CLOAKETH',
GNTBTC = 'GNTBTC',
GNTETH = 'GNTETH',
GNTBNB = 'GNTBNB',
LOOMBTC = 'LOOMBTC',
LOOMETH = 'LOOMETH',
LOOMBNB = 'LOOMBNB',
XRPUSDT = 'XRPUSDT',
BCNBTC = 'BCNBTC',
BCNETH = 'BCNETH',
BCNBNB = 'BCNBNB',
REPBTC = 'REPBTC',
REPETH = 'REPETH',
REPBNB = 'REPBNB',
BTCTUSD = 'BTCTUSD',
TUSDBTC = 'TUSDBTC',
ETHTUSD = 'ETHTUSD',
TUSDETH = 'TUSDETH',
TUSDBNB = 'TUSDBNB',
ZENBTC = 'ZENBTC',
ZENETH = 'ZENETH',
ZENBNB = 'ZENBNB',
SKYBTC = 'SKYBTC',
SKYETH = 'SKYETH',
SKYBNB = 'SKYBNB',
EOSUSDT = 'EOSUSDT',
EOSBNB = 'EOSBNB',
CVCBTC = 'CVCBTC',
CVCETH = 'CVCETH',
CVCBNB = 'CVCBNB',
THETABTC = 'THETABTC',
THETAETH = 'THETAETH',
THETABNB = 'THETABNB',
XRPBNB = 'XRPBNB',
TUSDUSDT = 'TUSDUSDT',
IOTAUSDT = 'IOTAUSDT',
XLMUSDT = 'XLMUSDT',
IOTXBTC = 'IOTXBTC',
IOTXETH = 'IOTXETH',
QKCBTC = 'QKCBTC',
QKCETH = 'QKCETH',
AGIBTC = 'AGIBTC',
AGIETH = 'AGIETH',
AGIBNB = 'AGIBNB',
NXSBTC = 'NXSBTC',
NXSETH = 'NXSETH',
NXSBNB = 'NXSBNB',
ENJBNB = 'ENJBNB',
DATABTC = 'DATABTC',
DATAETH = 'DATAETH',
ONTUSDT = 'ONTUSDT',
TRXBNB = 'TRXBNB',
TRXUSDT = 'TRXUSDT',
ETCUSDT = 'ETCUSDT',
ETCBNB = 'ETCBNB',
ICXUSDT = 'ICXUSDT',
SCBTC = 'SCBTC',
SCETH = 'SCETH',
SCBNB = 'SCBNB',
NPXSBTC = 'NPXSBTC',
NPXSETH = 'NPXSETH',
VENUSDT = 'VENUSDT',
KEYBTC = 'KEYBTC',
KEYETH = 'KEYETH',
NASBTC = 'NASBTC',
NASETH = 'NASETH',
NASBNB = 'NASBNB',
MFTBTC = 'MFTBTC',
MFTETH = 'MFTETH',
MFTBNB = 'MFTBNB',
DENTBTC = 'DENTBTC',
DENTETH = 'DENTETH',
ARDRBTC = 'ARDRBTC',
ARDRETH = 'ARDRETH',
ARDRBNB = 'ARDRBNB',
NULSUSDT = 'NULSUSDT',
HOTBTC = 'HOTBTC',
HOTETH = 'HOTETH',
VETBTC = 'VETBTC',
VETETH = 'VETETH',
VETUSDT = 'VETUSDT',
VETBNB = 'VETBNB',
DOCKBTC = 'DOCKBTC',
DOCKETH = 'DOCKETH',
POLYBTC = 'POLYBTC',
POLYBNB = 'POLYBNB',
PHXBTC = 'PHXBTC',
PHXETH = 'PHXETH',
PHXBNB = 'PHXBNB',
HCBTC = 'HCBTC',
HCETH = 'HCETH',
GOBTC = 'GOBTC',
GOBNB = 'GOBNB',
PAXBTC = 'PAXBTC',
PAXBNB = 'PAXBNB',
PAXUSDT = 'PAXUSDT',
PAXETH = 'PAXETH',
RVNBTC = 'RVNBTC',
RVNBNB = 'RVNBNB',
DCRBTC = 'DCRBTC',
DCRBNB = 'DCRBNB',
USDCBNB = 'USDCBNB',
MITHBTC = 'MITHBTC',
MITHBNB = 'MITHBNB',
BCHABCBTC = 'BCHABCBTC',
BCHSVBTC = 'BCHSVBTC',
BCHABCUSDT = 'BCHABCUSDT',
BCHSVUSDT = 'BCHSVUSDT',
BNBPAX = 'BNBPAX',
BTCPAX = 'BTCPAX',
ETHPAX = 'ETHPAX',
XRPPAX = 'XRPPAX',
EOSPAX = 'EOSPAX',
XLMPAX = 'XLMPAX',
RENBTC = 'RENBTC',
RENBNB = 'RENBNB',
BNBTUSD = 'BNBTUSD',
XRPTUSD = 'XRPTUSD',
EOSTUSD = 'EOSTUSD',
XLMTUSD = 'XLMTUSD',
BNBUSDC = 'BNBUSDC',
BTCUSDC = 'BTCUSDC',
ETHUSDC = 'ETHUSDC',
XRPUSDC = 'XRPUSDC',
EOSUSDC = 'EOSUSDC',
XLMUSDC = 'XLMUSDC',
USDCUSDT = 'USDCUSDT',
ADATUSD = 'ADATUSD',
TRXTUSD = 'TRXTUSD',
NEOTUSD = 'NEOTUSD',
TRXXRP = 'TRXXRP',
XZCXRP = 'XZCXRP',
PAXTUSD = 'PAXTUSD',
USDCTUSD = 'USDCTUSD',
USDCPAX = 'USDCPAX',
LINKUSDT = 'LINKUSDT',
LINKTUSD = 'LINKTUSD',
LINKPAX = 'LINKPAX',
LINKUSDC = 'LINKUSDC',
WAVESUSDT = 'WAVESUSDT',
WAVESTUSD = 'WAVESTUSD',
WAVESPAX = 'WAVESPAX',
WAVESUSDC = 'WAVESUSDC',
BCHABCTUSD = 'BCHABCTUSD',
BCHABCPAX = 'BCHABCPAX',
BCHABCUSDC = 'BCHABCUSDC',
BCHSVTUSD = 'BCHSVTUSD',
BCHSVPAX = 'BCHSVPAX',
BCHSVUSDC = 'BCHSVUSDC',
LTCTUSD = 'LTCTUSD',
LTCPAX = 'LTCPAX',
LTCUSDC = 'LTCUSDC',
TRXPAX = 'TRXPAX',
TRXUSDC = 'TRXUSDC',
BTTBTC = 'BTTBTC',
BTTBNB = 'BTTBNB',
BTTUSDT = 'BTTUSDT',
BNBUSDS = 'BNBUSDS',
BTCUSDS = 'BTCUSDS',
USDSUSDT = 'USDSUSDT',
USDSPAX = 'USDSPAX',
USDSTUSD = 'USDSTUSD',
USDSUSDC = 'USDSUSDC',
BTTPAX = 'BTTPAX',
BTTTUSD = 'BTTTUSD',
BTTUSDC = 'BTTUSDC',
ONGBNB = 'ONGBNB',
ONGBTC = 'ONGBTC',
ONGUSDT = 'ONGUSDT',
HOTBNB = 'HOTBNB',
HOTUSDT = 'HOTUSDT',
ZILUSDT = 'ZILUSDT',
ZRXBNB = 'ZRXBNB',
ZRXUSDT = 'ZRXUSDT',
FETBNB = 'FETBNB',
FETBTC = 'FETBTC',
FETUSDT = 'FETUSDT',
BATUSDT = 'BATUSDT',
XMRBNB = 'XMRBNB',
XMRUSDT = 'XMRUSDT',
ZECBNB = 'ZECBNB',
ZECUSDT = 'ZECUSDT',
ZECPAX = 'ZECPAX',
ZECTUSD = 'ZECTUSD',
ZECUSDC = 'ZECUSDC',
IOSTBNB = 'IOSTBNB',
IOSTUSDT = 'IOSTUSDT',
CELRBNB = 'CELRBNB',
CELRBTC = 'CELRBTC',
CELRUSDT = 'CELRUSDT',
ADAPAX = 'ADAPAX',
ADAUSDC = 'ADAUSDC',
NEOPAX = 'NEOPAX',
NEOUSDC = 'NEOUSDC',
DASHBNB = 'DASHBNB',
DASHUSDT = 'DASHUSDT',
NANOUSDT = 'NANOUSDT',
OMGBNB = 'OMGBNB',
OMGUSDT = 'OMGUSDT',
THETAUSDT = 'THETAUSDT',
ENJUSDT = 'ENJUSDT',
MITHUSDT = 'MITHUSDT',
MATICBNB = 'MATICBNB',
MATICBTC = 'MATICBTC',
MATICUSDT = 'MATICUSDT',
ATOMBNB = 'ATOMBNB',
ATOMBTC = 'ATOMBTC',
ATOMUSDT = 'ATOMUSDT',
ATOMUSDC = 'ATOMUSDC',
ATOMPAX = 'ATOMPAX',
ATOMTUSD = 'ATOMTUSD',
ETCUSDC = 'ETCUSDC',
ETCPAX = 'ETCPAX',
ETCTUSD = 'ETCTUSD',
BATUSDC = 'BATUSDC',
BATPAX = 'BATPAX',
BATTUSD = 'BATTUSD',
PHBBNB = 'PHBBNB',
PHBBTC = 'PHBBTC',
PHBUSDC = 'PHBUSDC',
PHBTUSD = 'PHBTUSD',
PHBPAX = 'PHBPAX',
TFUELBNB = 'TFUELBNB',
TFUELBTC = 'TFUELBTC',
TFUELUSDT = 'TFUELUSDT',
TFUELUSDC = 'TFUELUSDC',
TFUELTUSD = 'TFUELTUSD',
TFUELPAX = 'TFUELPAX',
ONEBNB = 'ONEBNB',
ONEBTC = 'ONEBTC',
ONEUSDT = 'ONEUSDT',
ONETUSD = 'ONETUSD',
ONEPAX = 'ONEPAX',
ONEUSDC = 'ONEUSDC',
FTMBNB = 'FTMBNB',
FTMBTC = 'FTMBTC',
FTMUSDT = 'FTMUSDT',
FTMTUSD = 'FTMTUSD',
FTMPAX = 'FTMPAX',
FTMUSDC = 'FTMUSDC',
BTCBBTC = 'BTCBBTC',
BCPTTUSD = 'BCPTTUSD',
BCPTPAX = 'BCPTPAX',
BCPTUSDC = 'BCPTUSDC',
ALGOBNB = 'ALGOBNB',
ALGOBTC = 'ALGOBTC',
ALGOUSDT = 'ALGOUSDT',
ALGOTUSD = 'ALGOTUSD',
ALGOPAX = 'ALGOPAX',
ALGOUSDC = 'ALGOUSDC',
USDSBUSDT = 'USDSBUSDT',
USDSBUSDS = 'USDSBUSDS',
GTOUSDT = 'GTOUSDT',
GTOPAX = 'GTOPAX',
GTOTUSD = 'GTOTUSD',
GTOUSDC = 'GTOUSDC',
ERDBNB = 'ERDBNB',
ERDBTC = 'ERDBTC',
ERDUSDT = 'ERDUSDT',
ERDPAX = 'ERDPAX',
ERDUSDC = 'ERDUSDC',
DOGEBNB = 'DOGEBNB',
DOGEBTC = 'DOGEBTC',
DOGEUSDT = 'DOGEUSDT',
DOGEPAX = 'DOGEPAX',
DOGEUSDC = 'DOGEUSDC',
DUSKBNB = 'DUSKBNB',
DUSKBTC = 'DUSKBTC',
DUSKUSDT = 'DUSKUSDT',
DUSKUSDC = 'DUSKUSDC',
DUSKPAX = 'DUSKPAX',
BGBPUSDC = 'BGBPUSDC',
ANKRBNB = 'ANKRBNB',
ANKRBTC = 'ANKRBTC',
ANKRUSDT = 'ANKRUSDT',
ANKRTUSD = 'ANKRTUSD',
ANKRPAX = 'ANKRPAX',
ANKRUSDC = 'ANKRUSDC',
ONTPAX = 'ONTPAX',
ONTUSDC = 'ONTUSDC',
WINBNB = 'WINBNB',
WINBTC = 'WINBTC',
WINUSDT = 'WINUSDT',
WINUSDC = 'WINUSDC',
COSBNB = 'COSBNB',
COSBTC = 'COSBTC',
COSUSDT = 'COSUSDT',
TUSDBTUSD = 'TUSDBTUSD',
NPXSUSDT = 'NPXSUSDT',
NPXSUSDC = 'NPXSUSDC',
COCOSBNB = 'COCOSBNB',
COCOSBTC = 'COCOSBTC',
COCOSUSDT = 'COCOSUSDT',
MTLUSDT = 'MTLUSDT',
TOMOBNB = 'TOMOBNB',
TOMOBTC = 'TOMOBTC',
TOMOUSDT = 'TOMOUSDT',
TOMOUSDC = 'TOMOUSDC',
PERLBNB = 'PERLBNB',
PERLBTC = 'PERLBTC',
PERLUSDC = 'PERLUSDC',
PERLUSDT = 'PERLUSDT',
DENTUSDT = 'DENTUSDT',
MFTUSDT = 'MFTUSDT',
KEYUSDT = 'KEYUSDT',
STORMUSDT = 'STORMUSDT',
DOCKUSDT = 'DOCKUSDT',
WANUSDT = 'WANUSDT',
FUNUSDT = 'FUNUSDT',
CVCUSDT = 'CVCUSDT',
BTTTRX = 'BTTTRX',
WINTRX = 'WINTRX',
CHZBNB = 'CHZBNB',
CHZBTC = 'CHZBTC',
CHZUSDT = 'CHZUSDT',
BANDBNB = 'BANDBNB',
BANDBTC = 'BANDBTC',
BANDUSDT = 'BANDUSDT',
BNBBUSD = 'BNBBUSD',
BTCBUSD = 'BTCBUSD',
BUSDUSDT = 'BUSDUSDT',
BEAMBNB = 'BEAMBNB',
BEAMBTC = 'BEAMBTC',
BEAMUSDT = 'BEAMUSDT',
XTZBNB = 'XTZBNB',
XTZBTC = 'XTZBTC',
XTZUSDT = 'XTZUSDT',
RENUSDT = 'RENUSDT',
RVNUSDT = 'RVNUSDT',
HCUSDT = 'HCUSDT',
HBARBNB = 'HBARBNB',
HBARBTC = 'HBARBTC',
HBARUSDT = 'HBARUSDT',
NKNBNB = 'NKNBNB',
NKNBTC = 'NKNBTC',
NKNUSDT = 'NKNUSDT',
XRPBUSD = 'XRPBUSD',
ETHBUSD = 'ETHBUSD',
BCHABCBUSD = 'BCHABCBUSD',
LTCBUSD = 'LTCBUSD',
LINKBUSD = 'LINKBUSD',
ETCBUSD = 'ETCBUSD',
STXBNB = 'STXBNB',
STXBTC = 'STXBTC',
STXUSDT = 'STXUSDT',
KAVABNB = 'KAVABNB',
KAVABTC = 'KAVABTC',
KAVAUSDT = 'KAVAUSDT',
BUSDNGN = 'BUSDNGN',
BNBNGN = 'BNBNGN',
BTCNGN = 'BTCNGN',
ARPABNB = 'ARPABNB',
ARPABTC = 'ARPABTC',
ARPAUSDT = 'ARPAUSDT',
TRXBUSD = 'TRXBUSD',
EOSBUSD = 'EOSBUSD',
IOTXUSDT = 'IOTXUSDT',
RLCUSDT = 'RLCUSDT',
MCOUSDT = 'MCOUSDT',
XLMBUSD = 'XLMBUSD',
ADABUSD = 'ADABUSD',
CTXCBNB = 'CTXCBNB',
CTXCBTC = 'CTXCBTC',
CTXCUSDT = 'CTXCUSDT',
BCHBNB = 'BCHBNB',
BCHBTC = 'BCHBTC',
BCHUSDT = 'BCHUSDT',
BCHUSDC = 'BCHUSDC',
BCHTUSD = 'BCHTUSD',
BCHPAX = 'BCHPAX',
BCHBUSD = 'BCHBUSD',
BTCRUB = 'BTCRUB',
ETHRUB = 'ETHRUB',
XRPRUB = 'XRPRUB',
BNBRUB = 'BNBRUB',
TROYBNB = 'TROYBNB',
TROYBTC = 'TROYBTC',
TROYUSDT = 'TROYUSDT',
BUSDRUB = 'BUSDRUB',
QTUMBUSD = 'QTUMBUSD',
VETBUSD = 'VETBUSD',
VITEBNB = 'VITEBNB',
VITEBTC = 'VITEBTC',
VITEUSDT = 'VITEUSDT',
FTTBNB = 'FTTBNB',
FTTBTC = 'FTTBTC',
FTTUSDT = 'FTTUSDT',
BTCTRY = 'BTCTRY',
BNBTRY = 'BNBTRY',
BUSDTRY = 'BUSDTRY',
ETHTRY = 'ETHTRY',
XRPTRY = 'XRPTRY',
USDTTRY = 'USDTTRY',
USDTRUB = 'USDTRUB',
BTCEUR = 'BTCEUR',
ETHEUR = 'ETHEUR',
BNBEUR = 'BNBEUR',
XRPEUR = 'XRPEUR',
EURBUSD = 'EURBUSD',
EURUSDT = 'EURUSDT',
OGNBNB = 'OGNBNB',
OGNBTC = 'OGNBTC',
OGNUSDT = 'OGNUSDT',
DREPBNB = 'DREPBNB',
DREPBTC = 'DREPBTC',
DREPUSDT = 'DREPUSDT',
BULLUSDT = 'BULLUSDT',
BULLBUSD = 'BULLBUSD',
BEARUSDT = 'BEARUSDT',
BEARBUSD = 'BEARBUSD',
ETHBULLUSDT = 'ETHBULLUSDT',
ETHBULLBUSD = 'ETHBULLBUSD',
ETHBEARUSDT = 'ETHBEARUSDT',
ETHBEARBUSD = 'ETHBEARBUSD',
TCTBNB = 'TCTBNB',
TCTBTC = 'TCTBTC',
TCTUSDT = 'TCTUSDT',
WRXBNB = 'WRXBNB',
WRXBTC = 'WRXBTC',
WRXUSDT = 'WRXUSDT',
ICXBUSD = 'ICXBUSD',
BTSUSDT = 'BTSUSDT',
BTSBUSD = 'BTSBUSD',
LSKUSDT = 'LSKUSDT',
BNTUSDT = 'BNTUSDT',
BNTBUSD = 'BNTBUSD',
LTOBNB = 'LTOBNB',
LTOBTC = 'LTOBTC',
LTOUSDT = 'LTOUSDT',
ATOMBUSD = 'ATOMBUSD',
DASHBUSD = 'DASHBUSD',
NEOBUSD = 'NEOBUSD',
WAVESBUSD = 'WAVESBUSD',
XTZBUSD = 'XTZBUSD',
EOSBULLUSDT = 'EOSBULLUSDT',
EOSBULLBUSD = 'EOSBULLBUSD',
EOSBEARUSDT = 'EOSBEARUSDT',
EOSBEARBUSD = 'EOSBEARBUSD',
XRPBULLUSDT = 'XRPBULLUSDT',
XRPBULLBUSD = 'XRPBULLBUSD',
XRPBEARUSDT = 'XRPBEARUSDT',
XRPBEARBUSD = 'XRPBEARBUSD',
BATBUSD = 'BATBUSD',
ENJBUSD = 'ENJBUSD',
NANOBUSD = 'NANOBUSD',
ONTBUSD = 'ONTBUSD',
RVNBUSD = 'RVNBUSD',
STRATBUSD = 'STRATBUSD',
STRATBNB = 'STRATBNB',
STRATUSDT = 'STRATUSDT',
AIONBUSD = 'AIONBUSD',
AIONUSDT = 'AIONUSDT',
MBLBNB = 'MBLBNB',
MBLBTC = 'MBLBTC',
MBLUSDT = 'MBLUSDT',
COTIBNB = 'COTIBNB',
COTIBTC = 'COTIBTC',
COTIUSDT = 'COTIUSDT',
ALGOBUSD = 'ALGOBUSD',
BTTBUSD = 'BTTBUSD',
TOMOBUSD = 'TOMOBUSD',
XMRBUSD = 'XMRBUSD',
ZECBUSD = 'ZECBUSD',
BNBBULLUSDT = 'BNBBULLUSDT',
BNBBULLBUSD = 'BNBBULLBUSD',
BNBBEARUSDT = 'BNBBEARUSDT',
BNBBEARBUSD = 'BNBBEARBUSD',
STPTBNB = 'STPTBNB',
STPTBTC = 'STPTBTC',
STPTUSDT = 'STPTUSDT',
BTCZAR = 'BTCZAR',
ETHZAR = 'ETHZAR',
BNBZAR = 'BNBZAR',
USDTZAR = 'USDTZAR',
BUSDZAR = 'BUSDZAR',
BTCBKRW = 'BTCBKRW',
ETHBKRW = 'ETHBKRW',
BNBBKRW = 'BNBBKRW',
WTCUSDT = 'WTCUSDT',
DATABUSD = 'DATABUSD',
DATAUSDT = 'DATAUSDT',
XZCUSDT = 'XZCUSDT',
SOLBNB = 'SOLBNB',
SOLBTC = 'SOLBTC',
SOLBUSD = 'SOLBUSD',
BTCIDRT = 'BTCIDRT',
BNBIDRT = 'BNBIDRT',
USDTIDRT = 'USDTIDRT',
BUSDIDRT = 'BUSDIDRT',
CTSIBTC = 'CTSIBTC',
CTSIUSDT = 'CTSIUSDT',
CTSIBNB = 'CTSIBNB',
CTSIBUSD = 'CTSIBUSD',
HIVEBNB = 'HIVEBNB',
HIVEBTC = 'HIVEBTC',
HIVEUSDT = 'HIVEUSDT',
CHRBNB = 'CHRBNB',
CHRBTC = 'CHRBTC',
CHRUSDT = 'CHRUSDT',
BTCUPUSDT = 'BTCUPUSDT',
BTCDOWNUSDT = 'BTCDOWNUSDT',
GXSUSDT = 'GXSUSDT',
ARDRUSDT = 'ARDRUSDT',
ERDBUSD = 'ERDBUSD',
LENDUSDT = 'LENDUSDT',
HBARBUSD = 'HBARBUSD',
MATICBUSD = 'MATICBUSD',
WRXBUSD = 'WRXBUSD',
ZILBUSD = 'ZILBUSD',
